1111111111111111111111
1000000000000000000001
1000000000000000000001
1000000000000000000001
1111111000000000011111
1000000000000000000001
1000000000110000000001
1111001111111111111111
