000011111111000
000000000000000
000010000000000
100010000000000
100000000100001
101001000000001
100000000000001
100001000100001
100000000000001
100001000000001
100000000000001
000001000100000
000000000000000
000000000000000
000011111100000
