111111111111111
100000000000001
100001000001001
110010111100001
101000000000001
101000000000001
111111111111111
